###########################
#................#........#
#...........e..........e..#
#....P#...................#
#.....................e...#
#...........e.............#
#.........#...............#
#...............#.........#
#....e.................e..#
###########################